je teste des trucs                                                           
                        
NO ../texture/path_to_the_north_texture
SO ../texutre/path_to_the_south_texture
WE ../texture/path_to_the_west_texture
EA ../texture/path_to_the_east_texture

F 220,100,0
C 225,30,0

            1111111111111111111
11111111111100000000000E0000001
111110000000000Y000000000000001
1111111111111111111111111111111
